######
# @  #
######

###
# #
#@#
###

#####
#@  #
#   #
#####
